10 10
.........T
XX...XX...
X.........
XXXXXXX...
....XG....
XXG.XGX.H.
....XXX...
XX...XX.K.
S.........
XX...XX...
